####################
# # #     #     #  #
# # # #   # #   # ##
#   # #   # #      #
# # # ##### #####   
# #             #  #
# # # #   # #   # ##
# # # #   # #   #  #
# ########### # #  #
# # #           #  #
# # # # ### # ### ##
# #   #     #   #  #
# # # # #   #   #  #
# # # # #   #   #  #
# # ################
# #             #  #
# # ### ### ##### ##
# #   #   #        #
# #   #   # #   #  #
######## ###########



